NO ./textures/kita.xpm
SO ./textures/minami.xpm
WE ./textures/nishi.xpm
EA ./textures/higashi.xpm
F 255,255,255
C 0,0,0

1111111111
1000000201
1000000001
100000W001
1000000001
1111111111