R 500 1500
NO ./textures/kita.xpm
SO ./textures/minami.xpm
WE ./textures/nishi.xpm
EA ./textures/higashi.xpm
S ./textures/barrel.xpm
F 0,255,0
C 0,255,255



111111111111111111111111
100000000000000000000001
100000000000200000000001
100000000000000000000001
100000111110000101010001
100000100010000000000001
100000100010000100010001
100000100010000000000001
100000110110000101010001
100000000000000000000001
100200000000000000000001
100000000001000000000001
100000000000000000000001
10000000000N000000000001
100020000000000000000001
100000000000000000000001
111111111000000000000001
110100001000000000000001
110000001000000000000001
110100001000000000200001
110111111000000000000001
110000000000000000000001
111111111000000000000001
111111111111111111111111
